XXXXXXXXX XXXXXXXXXX
X                  X
X                  X
X        X         X
X        X         X
X        X         X
X                  X
X                  X
                    
XXXXXXXXX XXXXXXXXXX
                    
X                  X
X                  X
X        X         X
X        X         X
X        X         X
X                  X
X                  X
X                  X
XXXXXXXXX XXXXXXXXXX
