XXXXXXXXXXXXXXXXXXXX
X   X              X
X                  X
X   X              X
X   X          X   X
X   XXXXXXXXXXXX   X
X   X              X
X   X              X
X   X              X
XXXXXXXXX XXXXXXXXXX
    X             
X   X              X
X   X   XXX   X    X
X   X         X    X
X   X         X    X
X   XXXXXXXXXXX    X
X                  X
X                  X
X                  X
XXXXXXXXXXXXXXXXXXXX
